*X*************
*W      2 *   *
* *** ** **** *
* *   *   1   *
* ***** ***** *
*  2 *   ** *F*
* ** ***  F   *
* 1********F  *
*************Y*
